00000011110000000
00000000000000000
00000000000000000
11000000000000001
11100000000000011
11000001100000001
11000011110000001
11000111111000011
11000111111000011
11000011110000001
11000001100000011
00000011110000111
00000111111000111
00001111111100111
11111111111111111
11111111111111111